{"grid":[
[1,1,1,1,1,3,12,12,2,1,1,1,1,5,0,4,1,1,1,1],
[1,5,0,4,1,1,1,1,1,5,0,0,0,0,8,0,1,5,0,4],
[0,0,8,0,1,5,0,4,1,0,8,0,2,3,9,2,1,0,8,0],
[1,3,0,0,0,0,8,0,0,0,0,2,1,1,9,1,1,3,9,2],
[1,1,1,1,1,3,0,2,1,1,1,1,1,1,9,0,4,1,9,1],
[1,5,0,4,1,1,1,1,1,5,0,0,0,0,9,8,0,1,9,1],
[0,0,8,0,1,5,0,4,5,0,8,0,2,1,9,0,2,1,9,0],
[1,3,9,2,1,0,8,0,0,0,9,2,1,1,9,1,1,5,9,4],
[1,1,9,1,1,3,9,2,1,1,9,1,1,5,9,4,1,0,8,0],
[1,5,9,4,1,1,9,1,1,5,9,4,1,0,8,0,1,3,0,2],
[1,0,8,0,0,0,9,4,1,0,8,0,1,3,0,2,1,1,1,1]],
"start":[1,10],
"secrets":{
  "finish":{
    "8":{"win":["That was fun wasn't it","jack","three"]},
    "12":{"win":["Ohh, you found a secret","jack","secret"]}}
},"blockset":"basic"}
